XXXXXXXXX
X000X000X
X0X0X0X0X
S0X000X0X
X0XXXXX0X
X0X0X000X
X0X0X0X0X
X0X0X0X0X
X000X0XXX
XXXXX0X0X
X0X000X0X
X0X0XXX0X
X000R000X
XXXXXXXXX